##############################
#   * *  *   V  ** *   *     #
# #*# #*# # # # #*#*# # # #  #
# I  *  D   * * *  I  * *    #
# # # # # # # # # # # # #I#* #
#*      I*     * * *     *   #
# # # # # #*# # # # # #I# # *#
#*         *     *I  D  *    #
# # #D# # # # # # # # #*# #  #
# *    V  *I    D   I   *    #
# # # # # # # # # # # #I# #* #
#   *    *    *I    ***  V   #
#*# # # # #*#*# # # # # #X#  #
#  **   *I*      *       *   #
##############################