##############################
#  **I *  K  *X*     *   I   #
# # # # # # # # # #*# # # #  #
# I      *     M   *         #
# # # # # # #I# # #*# # # #  #
#      *   *    *  I*  K   * #
# # # # # # # # # # # # # #  #
#I  M I   M  *  K   **   **  #
# # # # # # # # # # # # # #  #
#I *  *   *   *    K   *   * #
# # # # #I# # # # # # # # # *#
#* I   *    *    *I*  *  *   #
# #*# # # #*# # #*# # # # #  #
#    *      M      I   *     #
##############################

